WE ./redbrick.xpm
SO ./mossy.xpm
EA ./wood.xpm
NO ./greystone.xpm

F 80 ,200,123
C 255,192,200


11111111111111111111111111111
10000000000000000000000000001
10000000000000000000000000001
10000000000000000000000000001
100000000W0000000100000000001
10000000000000000000000000001
10000000000000000001010000001
11000001110101011111011110101
11110111 1110111 101111010001
11111111 1111111 111111111111
