111111
10C001
101111
1P1001
1010E1
111111