111111111111
100000000001
1000C00M0001
100000000C01
100C11111001
100010001001
10C010E01001
100C10001001
1000111110C1
10P00000C001
1M0000000001
111111111111