111111111111111111111111111111
1E0000000000000C0M001C00001111
101000011010000010100100001111
111001001010101000100100001111
1P0000M00CC0C000000000M0011111
10000000000M000000000000000001
100001000M000C00000000C0000001
100000000000000001M00000000001
10000C000000000000000000000001
10001100000M0000111000000C0001
100000C0000000000C0000000M0001
100000C0000000000C000000000001
1000000000M0000000000000000001
1M000000010000000C0000100M0001
1000000M0000010000000000M00001
100M00C0000100000C0000000M0001
111111111111111111111111111111