111111111111111111111111111
1E0000000000000C0M001C00001
101000011010000010100100001
111001001010101000100100M01
1P00M0000CC0C00000000000011
111111111111111111111111111